"filename", "language", "Solidity", "comment", "blank", "total"
"d:\Data\4.Coding\Solidity\Tapioca\TapiocaZ\contracts\LZV2\tOFT\modules\ModuleManager.sol", "Solidity", 25, 43, 10, 78
"d:\Data\4.Coding\Solidity\Tapioca\TapiocaZ\contracts\LZV2\tOFT\modules\TOFTv2GenericReceiverModule.sol", "Solidity", 42, 39, 16, 97
"d:\Data\4.Coding\Solidity\Tapioca\TapiocaZ\contracts\LZV2\tOFT\modules\TOFTv2MarketReceiverModule.sol", "Solidity", 112, 100, 32, 244
"d:\Data\4.Coding\Solidity\Tapioca\TapiocaZ\contracts\LZV2\tOFT\modules\TOFTv2OptionsReceiverModule.sol", "Solidity", 96, 52, 27, 175
"d:\Data\4.Coding\Solidity\Tapioca\TapiocaZ\contracts\LZV2\tOFT\modules\TOFTv2Receiver.sol", "Solidity", 219, 148, 44, 411
"d:\Data\4.Coding\Solidity\Tapioca\TapiocaZ\contracts\LZV2\tOFT\modules\TOFTv2Sender.sol", "Solidity", 27, 51, 9, 87
"d:\Data\4.Coding\Solidity\Tapioca\TapiocaZ\contracts\tOFT\modules\BaseTOFTGenericModule.sol", "Solidity", -262, -10, -36, -308
"d:\Data\4.Coding\Solidity\Tapioca\TapiocaZ\contracts\tOFT\modules\BaseTOFTLeverageDestinationModule.sol", "Solidity", -189, -6, -16, -211
"d:\Data\4.Coding\Solidity\Tapioca\TapiocaZ\contracts\tOFT\modules\BaseTOFTLeverageModule.sol", "Solidity", -87, -6, -12, -105
"d:\Data\4.Coding\Solidity\Tapioca\TapiocaZ\contracts\tOFT\modules\BaseTOFTMarketDestinationModule.sol", "Solidity", -250, -8, -29, -287
"d:\Data\4.Coding\Solidity\Tapioca\TapiocaZ\contracts\tOFT\modules\BaseTOFTMarketModule.sol", "Solidity", -139, -17, -23, -179
"d:\Data\4.Coding\Solidity\Tapioca\TapiocaZ\contracts\tOFT\modules\BaseTOFTOptionsDestinationModule.sol", "Solidity", -191, -3, -18, -212
"d:\Data\4.Coding\Solidity\Tapioca\TapiocaZ\contracts\tOFT\modules\BaseTOFTOptionsModule.sol", "Solidity", -96, -6, -15, -117
"d:\Data\4.Coding\Solidity\Tapioca\TapiocaZ\contracts\tOFT\modules\TOFTCommon.sol", "Solidity", -139, -4, -8, -151
"Total", "-", -832, 373, -19, -478